1111111111111111111111111111111111111111
1P             Q                       1
1  1  1  1  1  1  1  1  1  1  1  1     1
1                                      1
1  1  1  1  1  1  1  1  1  1  1  1     1
1                                      1
1  1  1  1  1  1  1  1  1  1  1  1     1
1                                      1
1  1  1  1  1  1  1  1  1  1  1  1     1
1                                      1
1  1  1  1  1  1  1  1  1  1  1  1     1
1                                      1
1  1  1  1  1  1  1  1  1  1  1  1     1
1  A                                   1
1111111111111111111111111111111111111111