1111111111
1P Q1
1 12345 1
1 A B C 1
1111111111