1111111111111111111111111111111111111111
1P  1   2   3   Q1                     1
1 1 1 1 1 1 1 1 1 1 1 1 1 1 1 1 1 1 1  1
1   2   3   4                        1
1 1 1 1 1 1 1 1 1 1 1 1 1 1 1 1 1 1 1 1
1   3   A   5                        1
1 1 1 1 1 1 1 1 1 1 1 1 1 1 1 1 1 1 1 1
1   4   2   3                        1
1 1 1 1 1 1 1 1 1 1 1 1 1 1 1 1 1 1 1 1
1   5   B   4                        1
1 1 1 1 1 1 1 1 1 1 1 1 1 1 1 1 1 1 1 1
1   3   2   5                        1
1 1 1 1 1 1 1 1 1 1 1 1 1 1 1 1 1 1 1 1
1   4   C   3                        1
1111111111111111111111111111111111111111